#,#,#,#,#,#,.,#,.,.,.
#,.,#,.,.,#,.,#,#,#,#
#,.,#,.,.,.,.,.,.,#,#
#,.,#,.,.,#,#,#,#,#,#
#,.,.,#,.,.,.,.,.,.,#
#,.,.,.,#,.,#,#,.,.,#
#,.,.,.,.,#,.,.,.,.,#
#,#,#,.,.,#,.,.,.,.,#
#,.,#,.,.,.,.,.,.,.,#
#,#,#,#,#,#,#,#,#,.,#
